********************
*  R *     *     R *
*    *     *    ****
*          *  R    *
*****   ****       *
*                  *
*     ***     *    *
*    H  *  R ****  *
*       *          *
********************